111100000000004
111011111111111
111100000011111
111111111011111
111000001100011
111011101111011
111100110111101
111110110001011
100000011110011
311111111111111
