111111110000000000000000000000000004
111111110111111111111111111111111111
111111110111111111111111111111111111
111111110111111111111111111111111111
111111100111111111111111111111111111
111110000111111111111111111111111111
111000110111111111111111111111111111
111000110001111111111111111111111111
111011111101111111111111111111111111
111011111100011111111111111111111111
000011001110011111111111111111111111
011000000000111111111111111111111111
010011111001111111111111111111111111
000001111111111111111111111111111111
001111111111111111111111111111111111
011111111111111111111111111111111111
011111111111111111111111111111111111
011111111111111111111111111111111111
011111111111111111111111111111111111
011111111111111111111111111111111111
311111111111111111111111111111111111