1111111111111111111111111111111111111111111111111111111111111411111111111111111111111111111111140004
1111111111111111111111111111111111111111111111111111111111111111111111111111111111111111111111000011
1111111111111111111111111111111111111111111111111111111111111111111111111111111111111111111111000011
1111111111111111111111111111111111111111111111111111111111111111111111111111111111111110011100000011
1111111111111111111111111111111111111111111111111111111111111111111111111111111111111110011100000111
1111111111111111111111111111111111111111111111111111111111111111111111111111111111111000000000101111
1111111111111111111111111111111111111111111111111111111111111111111111111111111111100011100000000111
1111111111111111111111111111111111111111111111111111111111111111111111111111111111001000001100000111
1111111111111111111111111111111111111111111111111111111111111111111111111111111110011001111100001111
1111111111111111111111111111111111111111111111111111111111111111111111111111000000000000111110001111
1111111111111111111111111111111111111111111111111111111111111111111100001111000000000000111111100111
1111111111111111111111111111111111111111111111111111000011111111111101100000000000000001111111100111
1111111111111111111111111111111111111111111111111100011001111000010000110000100000000011111111101111
1111111111111111111111111111111111111111111111111101111101110011000000000011111000111001110001101111
1111111111111111111111111111111111111111111111110001111100010111111001111111111000111101000100001111
1111111111111111111111111111111111111111111110000111111100000001111011111110000011111100011111111111
1111111111111111111111111111111111111111111110000111111000000001111000000000111111111111111111111111
1111111111111111111111111111111111111111111111000111111000000001111100111111111111111111111111111111
1111111111111111111111111111111111111111111111100111110000011111000000111111111111111111111111111111
1111111111111111111111111111111111111111111111101111110000011111010011111111111111111111111111111111
1111111111111111111111111111111111111111111111001111111110011110000111111111111111111111111111111111
1111111111111111111111111111111111111111111111000111111111110000111111111111111111111111111111111111
1111111111111111111111111111111111111111111111000111111111110011111111111111111111111111111111111111
1111111111111111111111111111111111111111111111110111111111100011111111111111111111111111111111111111
1111111111111111111111111111111111111111111111110111111111100111111111111111111111111111111111111111
1111111111111111111111111111111111111111111111100111111111000111111111111111111111111111111111111111
1111111111111111111111111111111111111111111111001111100000010111111111111111111111111111111111111111
1111111111111111111111111111111111111111000000011111001111110111111111111111111111111111111111111111
1111111111111111111111111111111111111110011111111100011111110111111111111111111111111111111111111111
1111111111111111111111111111111111111110111111000001111110000111111111111111111111111111111111111111
1111111111111111111111111111111111111100111100000000011110111111111111111111111111111111111111111111
1111111111111111111111111111111111111101111001101001000000011111111111111111111111111111111111111111
1111111111111111111111111111111111111100010011001111100000011111111111111111111111111111111111111111
1111111111111111111111111111111111000000000111011111100000111111111111111111111111111111111111111111
1111111111111111111111111110000000011000001110011111111111111111111111111111111111111111111111111111
1111111111111111111111000110100110000000011100111111111111111111111111111111111111111111111111111111
1111111111111111111111000000001111100000111100111111111111111111111111111111111111111111111111111111
1111111111111111111111000010111111111111110000111111111111111111111111111111111111111111111111111111
1111111111111111100011011110110011111111110111111111111111111111111111111111111111111111111111111111
1111111111111111100011001110110011111111110111111111111111111111111111111111111111111111111111111111
1111111111111111100000001000100011111111100111111111111111111111111111111111111111111111111111111111
1111111111111111001111111000000011111110001111111111111111111111111111111111111111111111111111111111
1111111111111111011111111110000000000000111111111111111111111111111111111111111111111111111111111111
1111111111111111011111110000011111111111111111111111111111111111111111111111111111111111111111111111
1111111111111100011111110111111111111111111111111111111111111111111111111111111111111111111111111111
1111111111100101111110000111111111111111111111111111111111111111111111111111111111111111111111111111
1111111111100001111100111111111111111111111111111111111111111111111111111111111111111111111111111111
1111111100000011100001111111111111111111111111111111111111111111111111111111111111111111111111111111
1111111101001111101111111111111111111111111111111111111111111111111111111111111111111111111111111111
1111111001111111100011111111111111111111111111111111111111111111111111111111111111111111111111111111
1111110011111111111011111111111111111111111111111111111111111111111111111111111111111111111111111111
1111100111111111100011111111111111111111111111111111111111111111111111111111111111111111111111111111
0011001111111111101111111111111111111111111111111111111111111111111111111111111111111111111111111111
0000011111111111101111111111111111111111111111111111111111111111111111111111111111111111111111111111
0000011111100000001111111111111111111111111111111111111111111111111111111111111111111111111111111111
0000001111001110011111111111111111111111111111111111111111111111111111111111111111111111111111111111
0000001100011111111111111111111111111111111111111111111111111111111111111111111111111111111111111111
0000000001111111111111111111111111111111111111111111111111111111111111111111111111111111111111111111
0000000001111111111111111111111111111111111111111111111111111111111111111111111111111111111111111111
0000000001111111111111111111111111111111111111111111111111111111111111111111111111111111111111111111
1110001101111111111111111111111111111111111111111111111111111111111111111111111111111111111111111111
1110001100011111111111111111111111111111111111111111111111111111111111111111111111111111111111111111
1110111111011111111111111111111111111111111111111111111111111111111111111111111111111111111111111111
1110111111000111111111111111111111111111111111111111111111111111111111111111111111111111111111111111
0000110011100111111111111111111111111111111111111111111111111111111111111111111111111111111111111111
0110000000001111111111111111111111111111111111111111111111111111111111111111111111111111111111111111
0100111110011111111111111111111111111111111111111111111111111111111111111111111111111111111111111111
0000011111111111111111111111111111111111111111111111111111111111111111111111111111111111111111111111
0000011111111111111111111111111111111111111111111111111111111111111111111111111111111111111111111111
0111111111111111111111111111111111111111111111111111111111111111111111111111111111111111111111111111
0111111111111111111111111111111111111111111111111111111111111111111111111111111111111111111111111111
0111111111111111111111111111111111111111111111111111111111111111111111111111111111111111111111111111
0111111111111111111111111111111111111111111111111111111111111111111111111111111111111111111111111111
0111111111111111111111111111111111111111111111111111111111111111111111111111111111111111111111111111
3111111111111111111111111111111111111111111111111111111111111111111111111111111111111111111111111111